XXXXXXXXXXXXXXXXXXXXXXXXXXXXXXXXXXXXXXXXXXXXXXXXXXXXXXXXXXXXXXXXXXXXXXXXXXXXXXXX                                          
X     X        X                                                               X                                          
X  X    @  X   X                       X           X                           X                                          
X     X     X  X                                                               X                                          
X  X           X        X         X                          X                 X                                          
XXXXXX    XXXXXX                             X                                 X                                          
X     X                                           X                 X          X                                          
X  X   X    C             X             X                                      X                                          
X                                                             X                X                                          
X         X      X               X                                             X                                          
X                                            X           X                     X                                          
X              X                                                               X                                          
X     X                     X                X         X               X       X                                          
X                                         X                                    X                                          
XXXXXXXXXXXXXXXXXXXXXXXXXXXXXXXX     XXXXXXXXXXXXXXXXXXXXXXXXXXXXXXXXXXXXXXXXXXX                                          
X  X                          X                                                X                                          
X          X             X                                           X         X                                          
X                  X         X           X       X        X                    X                                          
X      X                                                              X        X                                          
X                 X                         X                                  X                                          
X                    X     X      =    &                       X               X                                          
X      X                                     X     X                           X                                          
X                  X     X   X            X              X                     X                                          
X                               X     X                                   X    X                                          
X           X            X                       X      X                      X                                          
X                  X        X            X                                     X                                          
X                               X                                         X    X                                          
X       X   X                                   X            X  X              X                                          
X                  X       X X            X                                    X                                          
X                               X     X                                   X    X                                          
X     X      X                                   X            X                X                                          
XXXXXXXXXXXXXXXXXXXXXXXXXXXXXXXXXXXXXXXXXXXXXXXXXXXXXXXXXXXXXXXXXXXXXXXXXXXXXXXX                                          
                                                                                                                          
                                                                                                                          
                                                                                                                          
                                                                                                                          
                                                                                                                          
                                                                                                                          
                                                                                                                          
                                                                                                                          
                                                                                                                          
                                                                                                                          
                                                                                                                          
                                                                                                                          
                                                                                                                          
                                                                                                                          
                                                                                                                          
                                                                                                                          
